################
#              #
#              #
#         #   ##
#              #
#              #
# a   #     #a #
# a    T       #
##a  #  a      #
#              #
#  ##a       a #
#           #  #
#S         #   #
#    #   a     #
#         a   ##
################
