################
#a Sm   #      #
# #        b   #
#     #    #   #
#   #    #     #
#     a  a     #
#      #  ma ab#
#a     T      ##
# a    a       #
#         #    #
#              #
#a      m  a   #
#       a      #
#       #      #
#a     aa #    #
################
