################
#   T   #   #  #
#              #
#    a     a   #
#              #
#              #
#              #
#              #
# S  #       # #
##           a #
#              #
#   #          #
#a    # a      #
#           #a #
#      a       #
################
