################
#       a      #
#   #  T#    a #
#              #
#         #    #
#              #
#         S   a#
# a       # aa##
#     #        #
#      # a     #
#       #a     #
# a          a #
#              #
#       a    # #
# a  a a       #
################
