################
#       #      #
#              #
# # a          #
#          #   #
#           a  #
#   #     a   ##
#        a     #
#   T    #     #
#              #
##          #  #
#  a      #    #
#              #
#S             #
#     a    #   #
################
