################
#       #      #
#   #          #
# #            #
#    a m    #  #
# a            #
#              #
# m            #
#  a           #
#    a         #
#      S    a a#
# a        b   #
#         a    #
#   a #        #
#       T    # #
################
