# # # # # # # # # # # # # # # # 
#           x             x   # 
#   T         # x       #     # 
#       x                     # 
# # #                         # 
# x           #               # 
# #                     #     # 
#   #       x #               # 
#   #                         # 
#           #     x     x x   # 
# S # x       #               # 
#           # x   x           # 
#                             # 
#           x x               # 
#               x             # 
# # # # # # # # # # # # # # # # 
