################
#            # #
#   a    a    ##
#   #a      #  #
#           # a#
#              #
# #       #    #
#              #
#     a    #   #
# #  #      a  #
#              #
# a  S     T   #
#         #    #
#              #
#    #       # #
################
