################
#              #
#    #   #     #
#             ##
#   a          #
#              #
#  a   S   #   #
#T             #
#      #       #
#a    # #      #
#              #
# m     a      #
#      m   #   #
#a# #         a#
# #            #
################
