################
#              #
#              #
#       #      #
#             ##
#            # #
#        a#    #
#    a         #
#              #
#S  a          #
#      #       #
#              #
#      aT      #
#             a#
#    #    a  # #
################
