################
#    #         #
#         m    #
#    a         #
#a          a  #
#        T     #
# a   #        #
#              #
#             a#
# #            #
#       a      #
#        S     #
#   a #  #a  a #
#     a        #
#    m       ###
################
