################
#       a      #
##    #        #
##       #     #
#   m  a # a   #
# a         #  #
#            # #
#              #
#   a      ##b #
#   #    S     #
#         a    #
#  a T   #     #
# a   #        #
#              #
#         a    #
################
