################
# #           ##
#             a#
#              #
#         #    #
#    #      aa #
#     a       ##
#      #   a   #
#    # # #     #
#         a    #
#     #      a #
# aa      a  # #
#             a#
#    a    T    #
#    S         #
################
