################
#        #     #
#ab#  ##a   #  #
#              #
##          a  #
#  a  a      m #
#       #a     #
#   T   m    a #
#         #m   #
# a  #   a#b   #
# a       #    #
#         S   ##
#    a  a      #
#   #          #
#  a           #
################
