################
##             #
#   #    #  #  #
#              #
#              #
#    a         #
#S   a  #   #  #
#  #       #   #
#      #       #
# a         #  #
#    a        a#
#  T#a        a#
#     ##       #
#              #
# # #    #     #
################
