################
#       #      #
# aa      #m   #
#              
#a S  aa      ##
#         #  # #
#              #
#    #         
#      aT#     
#   a        # #
#  #           #
# #            #
#       #      #
#              #
#     a        #
################
