################
#    a       # #
#    a  #      #
#   T#         #
#             a#
#              #
#              #
#aa            #
# # # a        #
#  S         a #
#         ##   #
#  #        a  #
#    #     #  a#
#              #
#    a         #
################
