################
#  #     mm# # #
#              #
#              #
#  #a a  # a   #
#  a a  a      #
#              #
#       #  T   #
#         bb   #
#    m #       #
#       a      #
#  #     #     #
#   a        a #
#  m# m #      #
# a         S  #
################
