################
#    #         #
# S a   T      #
#              #
#              #
#              #
#         a #  #
#     a       a#
#          #   #
#      #       #
#         #    #
#              #
#        #     #
# #            #
#      a     a #
################
