################
#        S     #
#  #    a      #
#          ##  #
#   b       #T #
#    a         #
#a# #     a a  #
#      #       #
#              #
#    #   a     #
#     m   b#   #
#          a# a#
#              #
#          a   #
#    ab        #
################
