################
#   S        a #
##   # a       #
#              #
#Ta            #
#     a #      #
##        #    #
#              #
# # #          #
#            # #
#            #a#
#      #       #
# a      ##  a #
# #  #         #
#   a#         #
################
