################
#              #
##             #
#       #      #
#              #
#       # m    #
#b             #
#        T   # #
#b    # #      #
#    b #   #  ##
#           m  #
#              #
#              #
#    #         #
#  #  S      # #
################
